-1 -1 -1 -1 -1 -1 -1 -1 -1 -1 -1 -1 -1 -1 -1
-1 00 01 -1 02 03 04 05 06 07 08 09 10 11 -1 
-1 12 -1 -1 -1 -1 -1 13 -1 -1 -1 -1 -1 14 -1 
-1 15 -1 16 17 18 19 20 21 22 23 24 -1 25 -1 
-1 26 -1 27 -1 -1 -1 -1 -1 -1 -1 28 -1 -1 -1 
-2 29 30 31 32 33 34 35 36 37 38 39 40 41 -2 
-1 42 43 44 45 46 -2 47 -2 48 49 50 51 52 -1 
-1 53 -1 -1 -1 54 55 56 57 58 -1 59 -1 60 -1 
-1 61 -1 62 -1 63 -2 64 -2 65 -1 66 -1 67 -1 
-1 -1 -1 68 -1 69 70 71 72 73 -1 74 -1 75 -1
-1 76 -1 77 -1 -1 -1 -1 -1 -1 -1 78 -1 79 -1
-1 80 -1 81 82 83 84 85 86 87 88 89 -1 90 -1
-1 91 -1 -1 -1 -1 -1 -1 -1 92 -1 -1 -1 93 -1
-1 94 95 96 97 98 99 100 101 102 103 104 105 106 -1
-1 -1 -1 -1 -1 -1 -1 -1 -1 -1 -1 -1 -1 -1 -1
